****************
*         *   E*
*    *    *   **
*    *    *    *
*    *    *    *
*    *    *    *
*S   *         *
****************
